000000000000000000000000000000000000
000000000000000000000000000000000000
000000000000000000000000000000000000
000000000000000000000000000000000000
000000000000000000000000000000000000
000000000000000000000000000000000000
000000000000000000000000000002130000
002111300000000000000000000000000000
000000000000000000000000000000000000
000000000000000002111113000000000000
X0000000E0000000X000000000000X00E0X0
021111111111111300000000000000211300